1111111111
1111111111
1P0001C0E1
1000010001
1000000001
1001111001
1111111111
1111111111
