11111111
1000C011
100P0111
110C1111
11C00011
111100E1
11111111