111111111111111
1P000000C000C11
100000000001111
100011111111111
10C000000111111
10000000000C001
100000000000001
1000CCCCCCCC001
100000000000001
100000000000001
100C00000E00001
111111111111111