1111111111111111111111111111111
10P10000000C1000000000C10000011
1000011111000010101111000010E01
1111111111111111111111111111111