1111111111111111111111111111111
1000000000001000000000010010011
1000011111000011100111100010001
1000110000001000000001000000001
1001000C000010000000C0010010011
1000011111001111100111100010001
10001100000010C0000001000000001
1001000000001000000000010010011
1000011111001111100111100010001
100000000000000000C001000000001
1001000000001000000000010010011
1000000111001111100111100010C01
1000100000001000000001000000001
1001000000000000000000010010011
1100011111001111100111100010001
11101100C00010000P0001000000CE1
1111111111111111111111111111111